16
29
11100000000000000000111111111
10001111111111111111111000101
10111100000000000000001010101
10111111111111111111101010101
10000000000000000000001010101
11111111111111111111101010101
10001100000000000000001010101
10101101110110111111111010101
1010000100011B100000000010101
10101101111111111111111010101
11101100000000000001111010101
11101111111111111101101010101
11100000000000001100001010101
11111101111111101111111010101
11111101111000000000000010001
A0000001111111111111111111111